12 12 12 12 12 12 12 12 12 12 12 12 12 12 12 12 12 12 12 12 12 12 12 12 12 12 12 12 12 12 12 12 12 12 12 12 12 12 12 12 12 12 12 12 12 12 12 12 12 12
12 12 12 12 12 12 12 12 12 12 12 12 12 12 12 12 12 12 12 12 12 12 12 12 12 12 12 12 12 12 12 12 12 12 12 12 12 12 12 12 12 12 12 12 12 12 12 12 12 12
12 12 12 12 12 12 12 12 12 12 12 12 12 12 12 12 12 12 12 12 12 12 12 12 12 12 12 12 12 12 12 12 12 12 12 12 12 12 12 12 12 12 12 12 12 12 12 12 12 12
12 12 12 12 12 12 12 12 12 12 12 12 12 12 12 12 12 12 12 12 12 12 12 12 12 12 12 12 12 12 12 12 12 12 12 12 12 12 12 12 12 12 12 12 12 12 12 12 12 12
12 12 12 12 11 10 11 10 11 11 11 11 10 10 11 11 10 10 10 11 11 11 11 10 10 11 11 10 11 10 11 10 10 11 11 11 10 11 10 11 10 10 11 10 11 11 12 12 12 12
12 12 12 12 10 11 10 11 10 11 10 10 11 11 11 11 10 11 10 11 10 10 11 11 11 11 11 10 10 10 10 10 10 11 11 11 10 10 10 11 11 11 10 10 10 10 12 12 12 12
12 12 12 12 10 10 10 10 10 10 10 11 10 11 10 11 10 10 10 10 11 10 10 11 11 11 10 11 11 11 11 11 10 10 10 10 11 11 11 10 10 10 10 10 11 10 12 12 12 12
12 12 12 12 10 11 10 10 11 10 10 11 11 11 11 40 40 40 40 40 40 40 40 40 40 40 40 11 10 11 11 11 11 10 11 10 11 11 11 10 10 11 10 11 10 10 12 12 12 12
12 12 12 12 10 10 11 10 11 11 10 10 11 10 11 40 26 26 26 26 26 26 26 26 26 26 40 11 11 10 10 10 10 11 11 11 10 11 10 10 11 11 11 11 11 10 12 12 12 12
12 12 12 12 11 11 11 11 10 11 11 11 11 10 11 40 26 26 26 26 26 26 26 26 26 26 40 10 11 11 11 10 10 10 10 11 11 10 11 10 11 11 10 10 10 11 12 12 12 12
12 12 12 12 11 10 11 10 10 10 11 10 10 11 11 40 26 26 26 26 26 26 26 26 26 26 40 10 10 10 10 11 10 11 11 10 11 11 10 11 11 10 10 11 11 11 12 12 12 12
12 12 12 12 10 11 10 10 11 10 10 10 10 10 11 40 26 26 26 26 26 26 26 26 26 26 40 10 10 10 11 10 10 10 11 11 10 11 11 10 11 11 10 11 10 11 12 12 12 12
12 12 12 12 10 11 10 11 10 10 11 10 11 11 10 40 26 26 26 26 26 26 26 26 26 26 40 11 11 11 10 10 11 11 10 11 11 10 10 10 11 11 10 11 10 11 12 12 12 12
12 12 12 12 11 10 10 10 10 10 11 11 10 10 10 40 26 26 26 26 26 26 26 26 26 26 40 11 10 11 11 11 11 11 11 11 11 10 11 10 11 10 10 11 10 11 12 12 12 12
12 12 12 12 11 11 11 10 10 10 10 11 10 10 10 40 26 26 26 26 26 26 26 26 26 26 40 11 11 11 11 10 11 10 11 10 11 10 11 11 10 11 11 10 11 10 12 12 12 12
12 12 12 12 10 10 11 10 10 10 10 11 10 10 11 40 40 40 40 40 40 40 40 40 26 26 40 11 11 11 10 11 11 11 10 10 11 10 11 10 10 11 10 11 11 10 12 12 12 12
12 12 12 12 10 11 10 10 10 11 11 11 10 11 11 10 10 11 10 10 11 11 11 40 31 26 40 10 10 10 11 11 11 11 10 10 11 11 10 11 10 10 10 10 11 11 12 12 12 12
12 12 12 12 10 11 11 11 11 10 11 11 10 11 11 11 10 10 11 11 11 10 10 40 26 26 40 11 11 10 11 11 11 11 11 10 11 11 11 11 11 11 11 11 11 10 12 12 12 12
12 12 12 12 11 11 11 10 10 11 11 11 11 11 10 10 10 11 10 10 10 10 11 40 26 26 40 11 11 10 10 10 10 11 10 10 11 10 11 11 10 11 10 11 10 10 12 12 12 12
12 12 12 12 10 10 10 11 10 10 11 11 11 11 10 10 11 10 11 11 10 10 10 40 26 26 40 10 10 10 10 10 10 11 11 11 11 11 10 10 11 11 11 11 11 10 12 12 12 12
12 12 12 12 11 10 10 11 10 10 11 10 11 10 10 40 40 40 40 40 40 40 40 40 26 26 40 10 11 11 11 11 11 10 10 11 10 10 10 11 10 10 10 10 11 11 12 12 12 12
12 12 12 12 10 11 10 10 11 11 11 11 10 11 10 40 26 26 26 26 26 26 26 26 26 26 40 10 10 10 11 11 11 11 11 11 10 11 10 10 11 10 10 11 10 10 12 12 12 12
12 12 12 12 10 10 10 10 11 10 11 11 11 10 10 40 26 26 26 26 26 26 26 26 26 26 40 10 10 10 10 10 10 11 11 10 11 11 10 10 10 11 11 10 11 10 12 12 12 12
12 12 12 12 11 11 11 11 10 10 10 10 11 11 10 40 26 26 26 26 26 26 26 26 26 26 40 11 11 11 11 11 10 11 11 10 10 11 11 10 11 11 11 11 10 11 12 12 12 12
12 12 12 12 10 10 10 11 10 11 40 40 40 40 40 40 26 26 26 26 26 26 26 26 26 26 40 11 11 11 11 10 11 10 10 11 10 11 11 11 10 10 11 10 11 11 12 12 12 12
12 12 12 12 10 11 11 11 10 11 40 11 11 10 11 26 26 26 26 26 26 26 26 26 26 26 40 10 11 10 10 11 11 10 10 10 10 11 11 10 11 11 10 11 11 10 12 12 12 12
12 12 12 12 11 11 11 10 10 10 40 11 10 40 40 40 26 26 26 26 26 26 26 26 26 26 40 11 10 11 10 10 10 10 11 11 11 10 10 10 11 11 11 11 10 10 12 12 12 12
12 12 12 12 11 10 10 11 11 10 40 10 10 40 10 40 26 26 26 26 26 26 26 26 26 26 40 11 11 10 10 10 10 11 11 10 10 11 10 11 10 10 11 10 10 11 12 12 12 12
12 12 12 12 10 10 10 11 10 11 40 10 10 40 10 40 40 40 40 40 40 40 40 40 40 40 40 10 10 11 11 10 10 10 10 11 11 10 11 10 11 11 11 11 10 11 12 12 12 12
12 12 12 12 11 11 10 11 10 10 40 10 11 40 11 11 10 10 11 35 35 36 36 31 27 28 30 10 11 10 10 11 10 10 10 10 11 10 11 11 10 10 10 11 10 11 12 12 12 12
12 12 12 12 10 10 10 10 11 11 40 11 10 40 11 11 11 10 10 11 11 10 11 11 11 11 10 11 10 10 10 10 11 11 11 11 11 11 11 10 11 11 10 10 10 11 12 12 12 12
12 12 12 12 11 11 11 11 10 11 40 10 11 40 10 11 10 10 11 11 11 11 11 10 11 10 11 11 10 11 10 11 11 10 10 11 10 11 10 11 10 11 11 10 10 10 12 12 12 12
12 12 12 12 11 10 10 11 10 10 40 10 11 40 10 10 11 11 10 11 11 10 10 11 11 10 10 10 10 11 11 10 10 11 11 11 10 11 11 11 11 11 11 10 11 10 12 12 12 12
12 12 12 12 11 10 10 11 10 11 40 26 26 40 40 40 40 40 40 40 40 40 10 11 10 10 11 11 11 10 11 10 10 11 11 11 11 11 10 11 10 10 10 10 10 10 12 12 12 12
12 12 12 12 11 10 10 10 10 10 40 26 26 26 26 26 26 26 26 26 26 40 11 10 10 10 11 10 10 10 10 10 11 10 11 11 11 11 11 10 10 10 10 11 10 11 12 12 12 12
12 12 12 12 11 10 11 11 11 11 40 26 26 26 26 26 26 26 26 26 26 40 11 10 10 11 10 11 10 10 11 11 10 11 11 11 10 10 11 10 10 11 11 10 11 10 12 12 12 12
12 12 12 12 10 10 11 11 10 11 40 26 26 26 26 26 26 26 26 26 26 40 10 10 11 10 10 11 10 10 11 10 10 10 10 10 11 10 11 10 11 11 11 11 11 11 12 12 12 12
12 12 12 12 11 11 11 11 10 11 40 26 26 26 26 26 26 26 26 26 26 40 10 11 10 11 11 10 10 10 10 10 10 10 10 11 11 11 10 11 11 10 10 11 10 10 12 12 12 12
12 12 12 12 10 10 10 10 10 11 40 26 26 26 26 26 26 26 26 26 26 40 10 10 10 11 10 10 10 11 11 10 11 11 10 10 10 10 11 11 11 10 10 10 10 11 12 12 12 12
12 12 12 12 11 11 11 10 11 11 40 26 26 26 26 26 26 26 26 26 26 40 11 10 11 11 11 11 11 10 11 10 10 11 10 10 10 11 10 10 10 11 10 10 10 11 12 12 12 12
12 12 12 12 10 11 10 10 11 11 40 26 26 26 26 26 26 26 26 26 26 40 11 10 10 10 10 11 10 10 10 11 11 11 11 10 11 10 11 10 10 10 10 11 11 11 12 12 12 12
12 12 12 12 11 10 11 10 10 11 40 40 40 40 40 40 40 40 40 40 40 40 11 11 11 10 10 11 10 11 10 10 11 11 11 11 10 11 11 10 11 11 10 11 10 10 12 12 12 12
12 12 12 12 11 10 11 10 10 11 11 11 10 10 10 10 10 11 10 11 10 11 11 11 11 11 10 11 10 10 10 11 11 11 10 11 11 11 10 10 11 10 10 11 11 11 12 12 12 12
12 12 12 12 11 11 11 11 10 11 11 11 10 10 10 10 11 11 10 11 10 11 11 10 10 11 10 10 11 10 10 11 11 11 11 11 10 11 11 10 10 10 10 10 10 10 12 12 12 12
12 12 12 12 10 10 11 11 11 10 10 10 10 11 11 11 11 11 11 11 11 11 11 11 11 11 10 11 11 11 11 10 10 11 11 11 11 10 10 11 11 10 11 11 10 11 12 12 12 12
12 12 12 12 10 10 10 11 11 10 10 10 10 10 10 10 11 11 10 10 11 10 10 10 11 11 11 10 10 11 10 10 11 10 11 10 10 11 10 11 11 10 10 10 10 11 12 12 12 12
12 12 12 12 12 12 12 12 12 12 12 12 12 12 12 12 12 12 12 12 12 12 12 12 12 12 12 12 12 12 12 12 12 12 12 12 12 12 12 12 12 12 12 12 12 12 12 12 12 12
12 12 12 12 12 12 12 12 12 12 12 12 12 12 12 12 12 12 12 12 12 12 12 12 12 12 12 12 12 12 12 12 12 12 12 12 12 12 12 12 12 12 12 12 12 12 12 12 12 12
12 12 12 12 12 12 12 12 12 12 12 12 12 12 12 12 12 12 12 12 12 12 12 12 12 12 12 12 12 12 12 12 12 12 12 12 12 12 12 12 12 12 12 12 12 12 12 12 12 12
12 12 12 12 12 12 12 12 12 12 12 12 12 12 12 12 12 12 12 12 12 12 12 12 12 12 12 12 12 12 12 12 12 12 12 12 12 12 12 12 12 12 12 12 12 12 12 12 12 12